1111111111
1000000001
1010000001
1010000001
1010000001
1010001101
1010000001
1010000001
1000020001
1111111111