11111111111111111111
10000000000000000001
10100000000000000001
10100000000000000001
10100000000000000001
10110011000000000001
10100000000000000001
10100000000000000001
10000200000000000001
10000000000000000001
10000000000000000001
10000000000000000001
10000000000000000001
10000000000000000001
10000000000000000001
10000000000001000001
10000000000011100001
10000000000001000001
10000000000000000001
11111111111111111111